        WE ./cow.jpg
SO ./cow.jpg
        NO      ./cow.jpg

        C   20, 	 30	,20  
EA      ./cow.jpg

  F              31,32,30,40
 
111111111
111111011
111111011
111111S11
111111111