NO ./textures/north.xpm
SO ./textures/south.xpm
WE ./textures/west.xpm
EA ./textures/east.xpm

F 120,120,120
C 225,225,255
 
        1111111111111111111111111
        1000000000110000000000001
        1011000001111111111111111
        1001000000000000000001
1111111110110000011111111111111
100000000011000001110111111111111
11110111111111011100000010001
11110111111111011101010010001
11000000110101011100000010001
10000000000000001100000E10001
10000000000000001101010010001
1100000111010101111101111000111
11111111111111111111111111111

